R 1920 1080
NO ./path_of_north_wall
SO ./path_of_south_wall
WE ./path_of_west_wall
EA ./path_of_east_wall
S ./path_of_sprite

F 0,100,170
C 255,105,120
11111111111111
10000000010011
111N0000000001
10001000000011
10010010000001
10010110010001
10010000100101
10001111000001
10000000000001
11111111111111