R 1000 1000
NO ./textures/wall2.xpm
SO ./textures/wall4.xpm
WE ./textures/wall3.xpm
EA ./textures/wall5.xpm

F 165, 158, 152
C 114, 170, 219

1111111111111
1000000000001
1000000000001
1000000000001
1000000000001
1000000000001
1000000000001
100S000000001
1000000000001
1000000000001
1000000000001
1000000000001
1000000000001
1000000000001
1111111111111
